//MAP CONVERTED BY dmm2tgm.py THIS HEADER COMMENT PREVENTS RECONVERSION, DO NOT REMOVE 
"aa" = (
/turf/open/space,
/area/space)
"ab" = (
/obj/structure/lattice,
/turf/open/space,
/area/space)
"ac" = (
/obj/structure/lattice,
/obj/effect/glowshroom/glowcap,
/turf/open/space,
/area/space)
"ad" = (
/turf/closed/wall/mineral/titanium,
/area/template/Labshuttle)
"ae" = (
/obj/structure/grille,
/obj/structure/window/reinforced/fulltile,
/turf/open/floor/mineral/titanium/blue{
	icon_state = "shuttlefloor3"
	},
/area/template/Labshuttle)
"af" = (
/obj/structure/sign/nosmoking_1,
/turf/closed/wall/mineral/titanium,
/area/template/Labshuttle)
"ag" = (
/obj/structure/toilet{
	pixel_y = 8
	},
/mob/living/simple_animal/hostile/retaliate/bat,
/turf/open/floor/mineral/titanium/blue{
	icon_state = "shuttlefloor3"
	},
/area/template/Labshuttle)
"ah" = (
/obj/machinery/door/window,
/obj/structure/window/reinforced{
	dir = 8
	},
/obj/machinery/shower,
/obj/effect/decal/cleanable/cobweb2,
/obj/effect/decal/cleanable/dirt,
/turf/open/floor/mineral/titanium/blue{
	icon_state = "shuttlefloor3"
	},
/area/template/Labshuttle)
"ai" = (
/obj/structure/closet,
/obj/item/clothing/under/suit_jacket/white,
/obj/item/clothing/suit/toggle/labcoat,
/obj/item/clothing/tie/medal/nobel_science,
/obj/effect/glowshroom/glowcap,
/turf/open/floor/mineral/titanium/blue{
	icon_state = "shuttlefloor3"
	},
/area/template/Labshuttle)
"aj" = (
/obj/structure/bed,
/obj/item/weapon/bedsheet/mime,
/obj/effect/decal/cleanable/cobweb2,
/obj/effect/decal/cleanable/dirt,
/obj/effect/decal/cleanable/generic,
/turf/open/floor/mineral/titanium/blue{
	icon_state = "shuttlefloor3"
	},
/area/template/Labshuttle)
"ak" = (
/obj/effect/decal/cleanable/cobweb,
/obj/effect/decal/cleanable/dirt,
/turf/open/floor/mineral/titanium/blue{
	icon_state = "shuttlefloor3"
	},
/area/template/Labshuttle)
"al" = (
/obj/item/weapon/hatchet,
/turf/open/floor/mineral/titanium/blue{
	icon_state = "shuttlefloor3"
	},
/area/template/Labshuttle)
"am" = (
/obj/machinery/suit_storage_unit/cmo,
/obj/effect/decal/cleanable/cobweb,
/turf/open/floor/mineral/titanium,
/area/template/Labshuttle)
"an" = (
/obj/machinery/portable_atmospherics/canister/oxygen,
/obj/structure/sign/securearea{
	desc = "A warning sign which reads 'EXTERNAL AIRLOCK'";
	icon_state = "space";
	layer = 4;
	name = "EXTERNAL AIRLOCK";
	pixel_x = 0;
	pixel_y = 32
	},
/turf/open/floor/mineral/titanium,
/area/template/Labshuttle)
"ao" = (
/obj/machinery/light_construct/small,
/obj/item/weapon/light/bulb,
/obj/effect/decal/cleanable/generic,
/obj/effect/glowshroom/glowcap,
/turf/open/floor/mineral/titanium/blue{
	icon_state = "shuttlefloor3"
	},
/area/template/Labshuttle)
"ap" = (
/turf/open/floor/mineral/titanium/blue{
	icon_state = "shuttlefloor3"
	},
/area/template/Labshuttle)
"aq" = (
/obj/machinery/door/airlock/shuttle,
/turf/open/floor/mineral/titanium/blue{
	icon_state = "shuttlefloor3"
	},
/area/template/Labshuttle)
"ar" = (
/obj/machinery/light_construct,
/obj/item/weapon/light/tube,
/turf/open/floor/mineral/titanium/blue{
	icon_state = "shuttlefloor3"
	},
/area/template/Labshuttle)
"as" = (
/obj/effect/decal/cleanable/dirt,
/obj/item/weapon/grown/bananapeel,
/obj/item/seeds/banana,
/turf/open/floor/mineral/titanium/blue{
	icon_state = "shuttlefloor3"
	},
/area/template/Labshuttle)
"at" = (
/obj/effect/decal/cleanable/dirt,
/obj/effect/glowshroom/glowcap,
/turf/open/floor/mineral/titanium/blue{
	icon_state = "shuttlefloor3"
	},
/area/template/Labshuttle)
"au" = (
/obj/machinery/light_construct,
/obj/effect/decal/cleanable/dirt,
/obj/effect/decal/cleanable/generic,
/turf/open/floor/mineral/titanium/blue{
	icon_state = "shuttlefloor3"
	},
/area/template/Labshuttle)
"av" = (
/obj/structure/lattice/catwalk,
/turf/open/space,
/area/template/Labshuttle)
"aw" = (
/obj/structure/sign/chemistry,
/turf/closed/wall/mineral/titanium,
/area/template/Labshuttle)
"ax" = (
/obj/effect/decal/cleanable/dirt,
/turf/open/floor/mineral/titanium/blue{
	icon_state = "shuttlefloor3"
	},
/area/template/Labshuttle)
"ay" = (
/obj/effect/glowshroom/glowcap,
/turf/open/space,
/area/space)
"az" = (
/obj/machinery/chem_master,
/obj/effect/decal/cleanable/cobweb,
/turf/open/floor/mineral/titanium,
/area/template/Labshuttle)
"aA" = (
/obj/machinery/chem_dispenser,
/obj/effect/decal/cleanable/dirt,
/turf/open/floor/mineral/titanium,
/area/template/Labshuttle)
"aB" = (
/obj/machinery/chem_heater,
/obj/structure/extinguisher_cabinet,
/obj/effect/decal/cleanable/dirt,
/turf/open/floor/mineral/titanium,
/area/template/Labshuttle)
"aC" = (
/obj/effect/decal/remains/human,
/obj/effect/decal/cleanable/cobweb,
/obj/effect/decal/cleanable/dirt,
/obj/effect/glowshroom/glowcap,
/obj/item/seeds/glowshroom,
/turf/open/floor/mineral/titanium/blue{
	icon_state = "shuttlefloor3"
	},
/area/template/Labshuttle)
"aD" = (
/obj/item/weapon/stock_parts/cell{
	charge = 100;
	maxcharge = 15000
	},
/turf/open/floor/mineral/titanium/blue{
	icon_state = "shuttlefloor3"
	},
/area/template/Labshuttle)
"aE" = (
/mob/living/simple_animal/hostile/retaliate/bat,
/turf/open/floor/mineral/titanium/blue{
	icon_state = "shuttlefloor3"
	},
/area/template/Labshuttle)
"aF" = (
/obj/item/weapon/poster/legit,
/turf/open/floor/mineral/titanium/blue{
	icon_state = "shuttlefloor3"
	},
/area/template/Labshuttle)
"aG" = (
/obj/machinery/space_heater,
/obj/effect/decal/cleanable/dirt,
/obj/effect/glowshroom/glowcap,
/turf/open/floor/mineral/titanium/blue{
	icon_state = "shuttlefloor3"
	},
/area/template/Labshuttle)
"aH" = (
/obj/machinery/power/apc{
	auto_name = 1;
	dir = 8;
	name = "Worn-out APC";
	pixel_x = -24;
	pixel_y = 0
	},
/turf/open/floor/mineral/titanium/blue{
	icon_state = "shuttlefloor3"
	},
/area/template/Labshuttle)
"aI" = (
/obj/item/stack/tile/light,
/turf/open/floor/mineral/titanium/blue{
	icon_state = "shuttlefloor3"
	},
/area/template/Labshuttle)
"aJ" = (
/obj/item/stack/tile/light,
/obj/effect/decal/cleanable/generic,
/turf/open/floor/mineral/titanium/blue{
	icon_state = "shuttlefloor3"
	},
/area/template/Labshuttle)
"aK" = (
/obj/structure/table/glass,
/obj/machinery/reagentgrinder,
/obj/item/weapon/reagent_containers/glass/beaker{
	pixel_x = 8;
	pixel_y = 2
	},
/obj/effect/decal/cleanable/dirt,
/obj/effect/glowshroom/glowcap,
/turf/open/floor/mineral/titanium,
/area/template/Labshuttle)
"aL" = (
/obj/structure/table/glass,
/obj/effect/decal/cleanable/dirt,
/obj/item/seeds/angel,
/obj/item/seeds/glowshroom,
/obj/item/seeds/reishi,
/obj/item/clothing/glasses/science,
/turf/open/floor/mineral/titanium,
/area/template/Labshuttle)
"aM" = (
/obj/structure/table/glass,
/obj/item/weapon/reagent_containers/glass/beaker{
	pixel_x = 8;
	pixel_y = 2
	},
/obj/item/weapon/reagent_containers/dropper,
/obj/effect/decal/cleanable/dirt,
/turf/open/floor/mineral/titanium,
/area/template/Labshuttle)
"aN" = (
/obj/structure/table,
/obj/effect/decal/cleanable/dirt,
/obj/item/weapon/storage/toolbox/syndicate,
/turf/open/floor/mineral/titanium/blue{
	icon_state = "shuttlefloor3"
	},
/area/template/Labshuttle)
"aO" = (
/obj/structure/table,
/turf/open/floor/mineral/titanium/blue{
	icon_state = "shuttlefloor3"
	},
/area/template/Labshuttle)
"aP" = (
/turf/open/floor/plasteel/stairs,
/area/template/Labshuttle)
"aQ" = (
/obj/structure/sign/botany,
/turf/closed/wall/mineral/titanium,
/area/template/Labshuttle)
"aR" = (
/obj/machinery/seed_extractor,
/obj/machinery/light_construct{
	dir = 8
	},
/turf/open/floor/mineral/titanium,
/area/template/Labshuttle)
"aS" = (
/obj/structure/table,
/obj/effect/decal/cleanable/dirt,
/obj/effect/decal/cleanable/generic,
/obj/item/seeds/poppy,
/obj/item/seeds/poppy,
/obj/item/seeds/cherry,
/obj/item/weapon/reagent_containers/spray/plantbgone,
/obj/item/weapon/cultivator,
/obj/item/weapon/scythe,
/turf/open/floor/mineral/titanium,
/area/template/Labshuttle)
"aT" = (
/obj/structure/sink/kitchen{
	pixel_y = 28
	},
/obj/machinery/light_construct{
	dir = 4
	},
/obj/effect/decal/cleanable/dirt,
/obj/effect/glowshroom/glowcap,
/obj/item/seeds/watermelon,
/turf/open/floor/mineral/titanium,
/area/template/Labshuttle)
"aU" = (
/obj/item/seeds/ambrosia,
/turf/open/floor/mineral/titanium/blue{
	icon_state = "shuttlefloor3"
	},
/area/template/Labshuttle)
"aV" = (
/obj/item/weapon/light/tube,
/turf/open/floor/mineral/titanium/blue{
	icon_state = "shuttlefloor3"
	},
/area/template/Labshuttle)
"aW" = (
/obj/effect/glowshroom/glowcap,
/obj/item/seeds/nettle,
/turf/open/floor/mineral/titanium/blue{
	icon_state = "shuttlefloor3"
	},
/area/template/Labshuttle)
"aX" = (
/obj/item/seeds/chili,
/turf/open/floor/mineral/titanium/blue{
	icon_state = "shuttlefloor3"
	},
/area/template/Labshuttle)
"aY" = (
/obj/item/weapon/reagent_containers/glass/bucket,
/turf/open/floor/mineral/titanium,
/area/template/Labshuttle)
"aZ" = (
/obj/machinery/hydroponics/constructable,
/obj/effect/decal/cleanable/dirt,
/turf/open/floor/mineral/titanium,
/area/template/Labshuttle)
"ba" = (
/obj/machinery/hydroponics/constructable,
/turf/open/floor/mineral/titanium,
/area/template/Labshuttle)
"bb" = (
/obj/machinery/hydroponics/constructable,
/obj/effect/decal/cleanable/dirt,
/obj/effect/decal/cleanable/generic,
/turf/open/floor/mineral/titanium,
/area/template/Labshuttle)
"bc" = (
/obj/item/seeds/tomato/blood,
/mob/living/simple_animal/hostile/retaliate/bat,
/turf/open/floor/mineral/titanium/blue{
	icon_state = "shuttlefloor3"
	},
/area/template/Labshuttle)

(1,1,1) = {"
aa
aa
ab
aa
aa
ay
aa
aa
aa
aa
ab
aa
ab
aa
aa
aa
"}
(2,1,1) = {"
aa
ad
ad
ad
ad
ad
ad
ad
ad
ad
ae
ae
ae
ad
aa
aa
"}
(3,1,1) = {"
ab
ad
ag
ao
ad
az
aH
aK
ad
aR
aU
aZ
ba
ad
ad
aa
"}
(4,1,1) = {"
aa
ad
ah
ap
ad
aA
aI
aL
ad
aS
aV
ap
bc
aZ
ae
ab
"}
(5,1,1) = {"
aa
ad
ad
aq
ad
aB
ap
aM
ad
ad
aW
ba
aE
ba
ae
aa
"}
(6,1,1) = {"
aa
ad
ai
ar
ad
ad
ax
ap
aP
aq
aX
bb
ap
ba
ae
aa
"}
(7,1,1) = {"
aa
ae
aj
ap
aw
aC
ap
aN
aQ
ad
aV
ap
aU
ba
ae
ab
"}
(8,1,1) = {"
ab
ad
ad
aq
ad
aD
aJ
aO
ad
aT
aY
ba
ba
ad
ad
aa
"}
(9,1,1) = {"
aa
ae
ak
ap
ax
ax
ad
ad
ad
ad
ae
ae
ae
ad
aa
aa
"}
(10,1,1) = {"
aa
af
al
as
ap
ar
ad
aa
aa
ay
ab
aa
ab
aa
aa
aa
"}
(11,1,1) = {"
aa
ad
ad
aq
ad
aE
ad
aa
aa
aa
aa
aa
aa
aa
aa
aa
"}
(12,1,1) = {"
aa
ad
am
at
ad
aF
ad
aa
aa
aa
aa
aa
aa
aa
aa
aa
"}
(13,1,1) = {"
ac
ad
an
au
ad
aG
ad
ay
aa
aa
aa
aa
aa
aa
aa
aa
"}
(14,1,1) = {"
aa
ad
ae
aq
ad
ae
ad
aa
aa
aa
aa
aa
aa
aa
aa
aa
"}
(15,1,1) = {"
aa
aa
ab
av
av
ab
aa
aa
aa
aa
aa
aa
aa
aa
aa
aa
"}
(16,1,1) = {"
aa
aa
ab
aa
aa
ab
aa
aa
aa
aa
aa
aa
aa
aa
aa
aa
"}
