//MAP CONVERTED BY dmm2tgm.py THIS HEADER COMMENT PREVENTS RECONVERSION, DO NOT REMOVE 
"a" = (
/turf/open/space,
/area/space)
"b" = (
/turf/closed/mineral,
/area/space)
"c" = (
/turf/closed/wall/mineral/clown,
/area/space)
"d" = (
/turf/closed/wall/mineral/plasma,
/area/space)
"e" = (
/turf/open/floor/plating/asteroid/airless,
/area/space)
"f" = (
/obj/machinery/door/airlock/clown,
/turf/open/floor/plating/asteroid/airless,
/area/space)
"g" = (
/obj/item/device/wormhole_jaunter,
/turf/open/floor/plating/asteroid/airless,
/area/space)
"h" = (
/mob/living/simple_animal/hostile/carp,
/turf/open/floor/plating/asteroid/airless,
/area/space)

(1,1,1) = {"
a
a
b
b
b
b
b
a
a
a
a
a
a
a
a
a
"}
(2,1,1) = {"
a
b
b
b
b
b
b
b
b
b
b
b
b
b
b
a
"}
(3,1,1) = {"
a
b
c
d
d
c
b
h
b
b
b
b
b
b
e
a
"}
(4,1,1) = {"
a
b
d
e
g
d
b
e
e
b
b
e
e
e
e
e
"}
(5,1,1) = {"
a
b
d
e
e
d
b
e
e
b
b
b
e
e
e
e
"}
(6,1,1) = {"
b
b
c
f
f
c
b
e
e
b
e
e
e
b
b
b
"}
(7,1,1) = {"
b
b
b
e
e
e
e
e
e
b
e
e
b
b
a
a
"}
(8,1,1) = {"
b
b
b
e
e
e
e
e
e
e
e
b
b
b
a
a
"}
(9,1,1) = {"
b
b
b
e
e
e
e
e
e
e
b
b
b
a
a
a
"}
(10,1,1) = {"
b
b
b
b
h
b
e
e
h
b
b
b
b
a
a
a
"}
(11,1,1) = {"
b
b
b
b
b
b
b
b
b
b
b
b
b
a
a
a
"}
(12,1,1) = {"
a
a
a
b
b
b
b
b
b
b
b
b
a
a
a
a
"}
(13,1,1) = {"
a
a
a
a
b
b
b
b
b
b
b
a
a
a
a
a
"}
(14,1,1) = {"
a
a
a
a
a
a
b
b
b
b
b
a
a
a
a
a
"}
(15,1,1) = {"
a
a
a
a
a
a
a
a
a
a
a
a
a
a
a
a
"}
(16,1,1) = {"
a
a
a
a
a
a
a
a
a
a
a
a
a
a
a
a
"}
