//MAP CONVERTED BY dmm2tgm.py THIS HEADER COMMENT PREVENTS RECONVERSION, DO NOT REMOVE 
"aa" = (
/turf/open/space,
/area/space)
"ab" = (
/turf/closed/wall/mineral/clown,
/area/template/Clown)
"ac" = (
/obj/structure/window/reinforced/fulltile,
/obj/structure/grille,
/turf/open/floor/plating,
/area/template/Clown)
"ad" = (
/obj/machinery/computer,
/turf/open/floor/plasteel/blueyellow,
/area/template/Clown)
"ae" = (
/obj/structure/chair/comfy/lime{
	dir = 1
	},
/turf/open/floor/plasteel/blueyellow,
/area/template/Clown)
"af" = (
/obj/structure/chair/comfy/lime{
	dir = 1
	},
/obj/item/weapon/stamp/clown,
/turf/open/floor/plasteel/blueyellow,
/area/template/Clown)
"ag" = (
/obj/structure/chair/comfy/lime{
	dir = 1
	},
/mob/living/simple_animal/hostile/retaliate/clown,
/turf/open/floor/plasteel/blueyellow,
/area/template/Clown)
"ah" = (
/obj/machinery/light,
/turf/open/floor/plasteel/blueyellow,
/area/template/Clown)
"ai" = (
/turf/open/floor/plasteel/blueyellow,
/area/template/Clown)
"aj" = (
/obj/machinery/door/airlock/clown,
/turf/open/floor/plasteel/blueyellow,
/area/template/Clown)
"ak" = (
/obj/machinery/door/poddoor{
	id = "cloongunleft";
	name = "Orbital Bomber Door"
	},
/turf/open/floor/plating,
/area/template/Clown)
"al" = (
/obj/machinery/mass_driver{
	dir = 8;
	id = "cloongunleft"
	},
/obj/structure/window/reinforced{
	dir = 4;
	pixel_x = 0
	},
/obj/machinery/portable_atmospherics/canister/toxins,
/obj/structure/window/reinforced{
	color = "#008000";
	dir = 1
	},
/turf/open/floor/plating{
	icon_state = "warnplate";
	dir = 8
	},
/area/template/Clown)
"am" = (
/obj/machinery/button/massdriver{
	id = "cloongunleft";
	name = "Mass Driver";
	pixel_x = -25;
	pixel_y = 25
	},
/turf/open/floor/plasteel/blueyellow,
/area/template/Clown)
"an" = (
/obj/machinery/button/massdriver{
	id = "cloongunright";
	name = "Mass Driver";
	pixel_x = 25;
	pixel_y = 25
	},
/turf/open/floor/plasteel/blueyellow,
/area/template/Clown)
"ao" = (
/obj/machinery/mass_driver{
	dir = 4;
	id = "cloongunright"
	},
/obj/structure/window/reinforced{
	dir = 8
	},
/obj/machinery/portable_atmospherics/canister/toxins,
/obj/structure/window/reinforced{
	color = "#008000";
	dir = 1
	},
/turf/open/floor/plating{
	icon_state = "warnplate";
	dir = 8
	},
/area/template/Clown)
"ap" = (
/obj/machinery/door/poddoor{
	id = "cloongunright";
	name = "Orbital Bomber Door"
	},
/turf/open/floor/plating,
/area/template/Clown)
"aq" = (
/obj/machinery/conveyor/auto{
	dir = 1
	},
/obj/machinery/portable_atmospherics/canister/toxins,
/obj/structure/window/reinforced{
	dir = 4;
	pixel_x = 0
	},
/obj/machinery/light{
	dir = 8
	},
/turf/open/floor/plasteel/blueyellow,
/area/template/Clown)
"ar" = (
/obj/machinery/conveyor/auto{
	dir = 1
	},
/obj/machinery/portable_atmospherics/canister/toxins,
/obj/structure/window/reinforced{
	dir = 8
	},
/obj/machinery/light{
	dir = 4;
	icon_state = "tube1"
	},
/turf/open/floor/plasteel/blueyellow,
/area/template/Clown)
"as" = (
/obj/machinery/door/window/eastleft,
/obj/machinery/conveyor/auto{
	dir = 1
	},
/obj/machinery/portable_atmospherics/canister/toxins,
/turf/open/floor/plasteel/blueyellow,
/area/template/Clown)
"at" = (
/obj/machinery/door/window/westright,
/obj/machinery/conveyor/auto{
	dir = 1
	},
/obj/machinery/portable_atmospherics/canister/toxins,
/turf/open/floor/plasteel/blueyellow,
/area/template/Clown)
"au" = (
/obj/structure/window/reinforced{
	dir = 8
	},
/obj/structure/window/reinforced,
/obj/structure/window/reinforced{
	dir = 1;
	layer = 2.9
	},
/obj/machinery/power/emitter/energycannon{
	active = 0;
	dir = 8;
	req_access = null
	},
/obj/structure/cable{
	icon_state = "0-4";
	d2 = 4
	},
/turf/open/floor/plating,
/area/template/Clown)
"av" = (
/obj/structure/chair/comfy/lime{
	dir = 8
	},
/obj/structure/cable{
	d1 = 4;
	d2 = 8;
	icon_state = "4-8";
	pixel_y = 0
	},
/mob/living/simple_animal/hostile/retaliate/clown,
/turf/open/floor/plasteel/blueyellow,
/area/template/Clown)
"aw" = (
/obj/structure/cable{
	d1 = 2;
	d2 = 8;
	icon_state = "2-8";
	tag = ""
	},
/turf/open/floor/plasteel/blueyellow,
/area/template/Clown)
"ax" = (
/obj/structure/chair/comfy/lime,
/turf/open/floor/plasteel/blueyellow,
/area/template/Clown)
"ay" = (
/obj/structure/chair/comfy/lime,
/obj/machinery/light{
	dir = 1
	},
/turf/open/floor/plasteel/blueyellow,
/area/template/Clown)
"az" = (
/obj/machinery/light{
	dir = 1
	},
/turf/open/floor/plasteel/blueyellow,
/area/template/Clown)
"aA" = (
/obj/structure/cable{
	d1 = 2;
	d2 = 4;
	icon_state = "2-4"
	},
/turf/open/floor/plasteel/blueyellow,
/area/template/Clown)
"aB" = (
/obj/structure/chair/comfy/lime{
	dir = 4
	},
/obj/structure/cable{
	d1 = 4;
	d2 = 8;
	icon_state = "4-8";
	pixel_y = 0
	},
/mob/living/simple_animal/hostile/retaliate/clown,
/turf/open/floor/plasteel/blueyellow,
/area/template/Clown)
"aC" = (
/obj/structure/window/reinforced{
	dir = 4;
	pixel_x = 0
	},
/obj/structure/window/reinforced,
/obj/structure/window/reinforced{
	dir = 1;
	layer = 2.9
	},
/obj/machinery/power/emitter/energycannon{
	active = 0;
	dir = 4;
	req_access = null
	},
/obj/structure/cable{
	d2 = 8;
	icon_state = "0-8"
	},
/turf/open/floor/plating,
/area/template/Clown)
"aD" = (
/obj/structure/cable{
	d1 = 1;
	d2 = 2;
	icon_state = "1-2"
	},
/turf/open/floor/plasteel/blueyellow,
/area/template/Clown)
"aE" = (
/obj/structure/table,
/obj/item/weapon/reagent_containers/food/snacks/breadslice/banana,
/obj/item/weapon/reagent_containers/food/snacks/breadslice/banana,
/obj/item/weapon/reagent_containers/food/snacks/grown/banana,
/obj/item/weapon/reagent_containers/food/snacks/store/bread/banana,
/turf/open/floor/plasteel/blueyellow,
/area/template/Clown)
"aF" = (
/obj/item/clothing/shoes/clown_shoes/banana_shoes,
/obj/item/clothing/gloves/color/rainbow/clown,
/turf/open/floor/plasteel/blueyellow,
/area/template/Clown)
"aG" = (
/obj/structure/statue/bananium/clown,
/turf/open/floor/plasteel/blueyellow,
/area/template/Clown)
"aH" = (
/obj/item/toy/figure/clown,
/turf/open/floor/plasteel/blueyellow,
/area/template/Clown)
"aI" = (
/obj/structure/chair/comfy/lime{
	dir = 8
	},
/obj/structure/cable{
	d1 = 4;
	d2 = 8;
	icon_state = "4-8";
	pixel_y = 0
	},
/turf/open/floor/plasteel/blueyellow,
/area/template/Clown)
"aJ" = (
/obj/structure/cable{
	d1 = 1;
	d2 = 2;
	icon_state = "1-2"
	},
/obj/structure/cable{
	d1 = 2;
	d2 = 4;
	icon_state = "2-4"
	},
/obj/structure/cable{
	d1 = 2;
	d2 = 8;
	icon_state = "2-8";
	tag = ""
	},
/turf/open/floor/plasteel/blueyellow,
/area/template/Clown)
"aK" = (
/obj/structure/cable{
	d1 = 4;
	d2 = 8;
	icon_state = "4-8";
	pixel_y = 0
	},
/turf/open/floor/plasteel/blueyellow,
/area/template/Clown)
"aL" = (
/obj/machinery/door/airlock/clown,
/obj/structure/cable{
	d1 = 4;
	d2 = 8;
	icon_state = "4-8";
	pixel_y = 0
	},
/turf/open/floor/plasteel/blueyellow,
/area/template/Clown)
"aM" = (
/obj/item/weapon/bikehorn,
/obj/item/weapon/cartridge/clown,
/obj/item/clothing/mask/gas/clown_hat,
/obj/structure/cable{
	d1 = 4;
	d2 = 8;
	icon_state = "4-8";
	pixel_y = 0
	},
/turf/open/floor/plasteel/blueyellow,
/area/template/Clown)
"aN" = (
/obj/structure/cable{
	icon_state = "0-4";
	d2 = 4
	},
/obj/structure/cable{
	d2 = 8;
	icon_state = "0-8"
	},
/obj/machinery/power/apc{
	dir = 3;
	name = "Honk Frigate APC";
	pixel_y = 24
	},
/turf/open/floor/plasteel/blueyellow,
/area/template/Clown)
"aO" = (
/obj/structure/chair/comfy/lime{
	dir = 4
	},
/obj/structure/cable{
	d1 = 4;
	d2 = 8;
	icon_state = "4-8";
	pixel_y = 0
	},
/turf/open/floor/plasteel/blueyellow,
/area/template/Clown)
"aP" = (
/obj/machinery/light{
	dir = 4;
	icon_state = "tube1"
	},
/turf/open/floor/plasteel/blueyellow,
/area/template/Clown)
"aQ" = (
/obj/structure/bed,
/obj/item/weapon/bedsheet/clown,
/obj/item/weapon/storage/backpack/clown,
/turf/open/floor/plasteel/blueyellow,
/area/template/Clown)
"aR" = (
/obj/structure/bed,
/obj/item/weapon/bedsheet/clown,
/obj/item/clothing/under/rank/clown,
/turf/open/floor/plasteel/blueyellow,
/area/template/Clown)
"aS" = (
/obj/structure/bed,
/obj/item/weapon/bedsheet/clown,
/turf/open/floor/plasteel/blueyellow,
/area/template/Clown)
"aT" = (
/obj/machinery/light{
	dir = 8
	},
/turf/open/floor/plasteel/blueyellow,
/area/template/Clown)
"aU" = (
/obj/structure/cable{
	d1 = 2;
	d2 = 8;
	icon_state = "2-8";
	tag = ""
	},
/obj/structure/cable{
	d1 = 1;
	d2 = 2;
	icon_state = "1-2"
	},
/turf/open/floor/plasteel/blueyellow,
/area/template/Clown)
"aV" = (
/obj/machinery/suit_storage_unit/clown,
/turf/open/floor/plasteel/blueyellow,
/area/template/Clown)
"aW" = (
/obj/structure/cable{
	d1 = 1;
	d2 = 2;
	icon_state = "1-2"
	},
/obj/structure/cable{
	d1 = 2;
	d2 = 4;
	icon_state = "2-4"
	},
/turf/open/floor/plasteel/blueyellow,
/area/template/Clown)
"aX" = (
/obj/machinery/power/smes/engineering{
	input_level = 200000
	},
/obj/structure/cable{
	icon_state = "0-4";
	d2 = 4
	},
/turf/open/floor/plasteel/blueyellow,
/area/template/Clown)
"aY" = (
/obj/structure/cable{
	d1 = 1;
	d2 = 8;
	icon_state = "1-8"
	},
/obj/structure/cable{
	d1 = 1;
	d2 = 2;
	icon_state = "1-2"
	},
/turf/open/floor/plasteel/blueyellow,
/area/template/Clown)
"aZ" = (
/obj/item/stack/sheet/mineral/bananium{
	amount = 25
	},
/obj/structure/closet/crate,
/turf/open/floor/plasteel/blueyellow,
/area/template/Clown)
"ba" = (
/obj/structure/shuttle/engine/heater,
/obj/structure/window/reinforced{
	dir = 1
	},
/turf/open/floor/plating,
/area/template/Clown)
"bb" = (
/obj/item/weapon/coin/clown,
/obj/item/weapon/coin/clown,
/obj/item/weapon/coin/clown,
/obj/item/weapon/coin/clown,
/obj/item/weapon/coin/clown,
/obj/item/weapon/coin/clown,
/obj/item/weapon/coin/clown,
/obj/item/weapon/coin/clown,
/obj/item/weapon/coin/clown,
/obj/item/weapon/coin/clown,
/obj/item/weapon/coin/clown,
/obj/item/weapon/coin/clown,
/obj/item/weapon/coin/clown,
/obj/structure/closet/crate,
/turf/open/floor/plasteel/blueyellow,
/area/template/Clown)
"bc" = (
/obj/structure/cable{
	d1 = 1;
	d2 = 2;
	icon_state = "1-2"
	},
/obj/structure/cable{
	d1 = 1;
	d2 = 4;
	icon_state = "1-4";
	tag = "90Curve"
	},
/turf/open/floor/plasteel/blueyellow,
/area/template/Clown)
"bd" = (
/obj/machinery/power/smes/engineering{
	input_level = 200000
	},
/obj/structure/cable{
	d2 = 8;
	icon_state = "0-8"
	},
/turf/open/floor/plasteel/blueyellow,
/area/template/Clown)
"be" = (
/obj/structure/shuttle/engine/heater,
/obj/structure/window/reinforced{
	dir = 1
	},
/obj/machinery/power/terminal{
	icon_state = "term";
	dir = 1
	},
/obj/structure/cable{
	icon_state = "0-4";
	d2 = 4
	},
/turf/open/floor/plating,
/area/template/Clown)
"bf" = (
/obj/structure/shuttle/engine/heater,
/obj/structure/window/reinforced{
	dir = 1
	},
/obj/structure/cable{
	d1 = 1;
	d2 = 8;
	icon_state = "1-8"
	},
/turf/open/floor/plating,
/area/template/Clown)
"bg" = (
/obj/structure/shuttle/engine/propulsion,
/turf/open/floor/plating,
/area/template/Clown)
"bh" = (
/obj/structure/shuttle/engine/heater,
/obj/structure/window/reinforced{
	dir = 1
	},
/obj/structure/cable{
	d1 = 1;
	d2 = 4;
	icon_state = "1-4"
	},
/turf/open/floor/plating,
/area/template/Clown)
"bi" = (
/obj/structure/shuttle/engine/heater,
/obj/structure/window/reinforced{
	dir = 1
	},
/obj/machinery/power/terminal{
	icon_state = "term";
	dir = 1
	},
/turf/open/floor/plating,
/area/template/Clown)

(1,1,1) = {"
aa
aa
aa
aa
aa
aa
aa
ab
au
ab
au
ab
au
ab
ab
ab
"}
(2,1,1) = {"
aa
aa
aa
aa
aa
aa
aa
ab
av
ai
aI
ai
av
aX
be
bg
"}
(3,1,1) = {"
aa
aa
aa
aa
aa
aa
aa
ab
aw
aD
aJ
aD
aU
aY
bf
bg
"}
(4,1,1) = {"
aa
aa
aa
aa
aa
aa
aa
ab
ai
ai
aK
aP
ai
aZ
ba
bg
"}
(5,1,1) = {"
ab
ac
ac
ab
aa
aa
aa
ab
ab
ab
aL
ab
ab
ab
ab
ab
"}
(6,1,1) = {"
ac
ad
ag
ab
ak
ab
ab
ab
ax
aE
aK
aQ
aV
ab
aa
aa
"}
(7,1,1) = {"
ac
ae
ah
ab
al
aq
as
ab
ay
aE
aK
aR
aV
ab
ab
aa
"}
(8,1,1) = {"
ac
af
ai
aj
am
ai
ai
aj
ai
ai
aK
aS
aV
ba
bg
aa
"}
(9,1,1) = {"
ac
ae
ai
aj
an
ai
ai
aj
ai
aF
aK
aS
aV
ba
bg
aa
"}
(10,1,1) = {"
ac
ae
ah
ab
ao
ar
at
ab
az
aG
aM
aS
aV
ab
ab
aa
"}
(11,1,1) = {"
ac
ad
ag
ab
ap
ab
ab
ab
aj
ab
aN
aS
aV
ab
aa
aa
"}
(12,1,1) = {"
ab
ac
ac
ab
aa
aa
aa
aj
ai
ab
aL
ab
ab
ab
ab
ab
"}
(13,1,1) = {"
aa
aa
aa
aa
aa
aa
aa
ab
ab
ab
aK
aT
ai
bb
ba
bg
"}
(14,1,1) = {"
aa
aa
aa
aa
aa
aa
aa
ab
aA
aD
aJ
aD
aW
bc
bh
bg
"}
(15,1,1) = {"
aa
aa
aa
aa
aa
aa
aa
ab
aB
aH
aO
ai
aB
bd
bi
bg
"}
(16,1,1) = {"
aa
aa
aa
aa
aa
aa
aa
ab
aC
ab
aC
ab
aC
ab
ab
ab
"}
