//MAP CONVERTED BY dmm2tgm.py THIS HEADER COMMENT PREVENTS RECONVERSION, DO NOT REMOVE 
"aa" = (
/turf/open/space,
/area/space)
"ab" = (
/turf/closed/wall/mineral/clown,
/area/template/OriginalClown)
"ac" = (
/obj/structure/grille,
/obj/structure/window/reinforced/fulltile,
/turf/open/space,
/area/template/OriginalClown)
"ad" = (
/obj/structure/statue/bananium/clown,
/turf/open/floor/mineral/titanium/blue{
	tag = "icon-whiteredfull";
	icon_state = "whiteredfull";
	dir = 2
	},
/area/template/OriginalClown)
"ae" = (
/obj/structure/table,
/obj/item/device/flashlight/lamp/bananalamp,
/turf/open/floor/mineral/titanium/blue{
	tag = "icon-whitegreenfull";
	icon_state = "whitegreenfull";
	dir = 2
	},
/area/template/OriginalClown)
"af" = (
/obj/structure/frame/computer,
/turf/open/floor/mineral/titanium/blue{
	tag = "icon-whiteredfull";
	icon_state = "whiteredfull";
	dir = 2
	},
/area/template/OriginalClown)
"ag" = (
/obj/structure/frame/computer,
/turf/open/floor/mineral/titanium/blue{
	tag = "icon-whitegreenfull";
	icon_state = "whitegreenfull";
	dir = 2
	},
/area/template/OriginalClown)
"ah" = (
/obj/structure/table,
/obj/item/weapon/bikehorn,
/turf/open/floor/mineral/titanium/blue{
	tag = "icon-whitegreenfull";
	icon_state = "whitegreenfull";
	dir = 2
	},
/area/template/OriginalClown)
"ai" = (
/turf/open/floor/mineral/titanium/blue{
	tag = "icon-whitegreenfull";
	icon_state = "whitegreenfull";
	dir = 2
	},
/area/template/OriginalClown)
"aj" = (
/turf/open/floor/mineral/titanium/blue{
	tag = "icon-whiteredfull";
	icon_state = "whiteredfull";
	dir = 2
	},
/area/template/OriginalClown)
"ak" = (
/obj/structure/chair/comfy/lime{
	dir = 1
	},
/mob/living/simple_animal/hostile/retaliate/clown,
/turf/open/floor/mineral/titanium/blue{
	tag = "icon-whitegreenfull";
	icon_state = "whitegreenfull";
	dir = 2
	},
/area/template/OriginalClown)
"al" = (
/obj/structure/closet/secure_closet/clown,
/obj/machinery/light{
	icon_state = "tube1";
	dir = 8
	},
/turf/open/floor/mineral/titanium/blue{
	tag = "icon-whiteredfull";
	icon_state = "whiteredfull";
	dir = 2
	},
/area/template/OriginalClown)
"am" = (
/obj/structure/bed,
/obj/item/weapon/bedsheet/clown,
/turf/open/floor/mineral/titanium/blue{
	tag = "icon-whitegreenfull";
	icon_state = "whitegreenfull";
	dir = 2
	},
/area/template/OriginalClown)
"an" = (
/turf/closed/wall/mineral/clown,
/obj/item/weapon/stamp/clown,
/obj/item/clothing/gloves/color/rainbow/clown,
/obj/item/clothing/mask/gas/clown_hat,
/obj/item/clothing/shoes/clown_shoes/banana_shoes,
/obj/item/clothing/suit/hooded/chaplain_hoodie,
/obj/item/clothing/head/collectable/welding,
/obj/item/weapon/twohanded/fireaxe,
/obj/item/weapon/veilrender/honkrender,
/obj/structure/safe,
/obj/machinery/light{
	dir = 4;
	icon_state = "tube1"
	},
/obj/item/weapon/coin/clown,
/obj/item/weapon/coin/clown,
/obj/item/weapon/coin/clown,
/obj/item/weapon/coin/clown,
/obj/item/weapon/coin/clown,
/obj/item/weapon/coin/clown,
/obj/item/weapon/coin/clown,
/obj/item/weapon/coin/clown,
/obj/item/weapon/coin/clown,
/turf/open/floor/mineral/titanium/blue{
	tag = "icon-whiteredfull";
	icon_state = "whiteredfull";
	dir = 2
	},
/area/template/OriginalClown)
"ao" = (
/obj/machinery/door/airlock/clown,
/turf/open/floor/mineral/titanium/blue{
	tag = "icon-whiteredfull";
	icon_state = "whiteredfull";
	dir = 2
	},
/area/template/OriginalClown)
"ap" = (
/obj/item/weapon/storage/toolbox/mechanical,
/turf/open/floor/mineral/titanium/blue{
	tag = "icon-whiteredfull";
	icon_state = "whiteredfull";
	dir = 2
	},
/area/template/OriginalClown)
"aq" = (
/obj/structure/window/reinforced{
	dir = 8
	},
/obj/structure/window/reinforced{
	dir = 1;
	layer = 2.9
	},
/obj/structure/window/reinforced,
/obj/structure/cable{
	icon_state = "0-4";
	d2 = 4
	},
/obj/machinery/power/emitter/energycannon{
	active = 0;
	dir = 8;
	icon_state = "emitter";
	in_use = 0;
	locked = 0;
	req_access = "0"
	},
/turf/open/floor/mineral/titanium/blue{
	tag = "icon-whiteredfull";
	icon_state = "whiteredfull";
	dir = 2
	},
/area/template/OriginalClown)
"ar" = (
/obj/item/chair{
	dir = 8
	},
/obj/structure/cable{
	d1 = 2;
	d2 = 8;
	icon_state = "2-8"
	},
/turf/open/floor/mineral/titanium/blue{
	tag = "icon-whitegreenfull";
	icon_state = "whitegreenfull";
	dir = 2
	},
/area/template/OriginalClown)
"as" = (
/mob/living/simple_animal/hostile/retaliate/clown,
/turf/open/floor/mineral/titanium/blue{
	tag = "icon-whiteredfull";
	icon_state = "whiteredfull";
	dir = 2
	},
/area/template/OriginalClown)
"at" = (
/obj/item/chair{
	dir = 4
	},
/obj/structure/cable{
	d1 = 2;
	d2 = 4;
	icon_state = "2-4"
	},
/turf/open/floor/mineral/titanium/blue{
	tag = "icon-whitegreenfull";
	icon_state = "whitegreenfull";
	dir = 2
	},
/area/template/OriginalClown)
"au" = (
/obj/structure/window/reinforced{
	dir = 4
	},
/obj/structure/window/reinforced,
/obj/structure/window/reinforced{
	dir = 1;
	layer = 2.9
	},
/obj/structure/cable{
	d2 = 8;
	icon_state = "0-8"
	},
/obj/machinery/power/emitter/energycannon{
	active = 0;
	dir = 4;
	locked = 0;
	req_access = "0"
	},
/turf/open/floor/mineral/titanium/blue{
	tag = "icon-whiteredfull";
	icon_state = "whiteredfull";
	dir = 2
	},
/area/template/OriginalClown)
"av" = (
/obj/structure/table,
/obj/item/device/flashlight/lamp/bananalamp,
/obj/item/weapon/reagent_containers/food/snacks/store/bread/banana,
/obj/machinery/light{
	icon_state = "tube1";
	dir = 8
	},
/obj/structure/cable{
	d1 = 1;
	d2 = 4;
	icon_state = "1-4"
	},
/obj/structure/cable{
	d1 = 2;
	d2 = 4;
	icon_state = "2-4"
	},
/turf/open/floor/mineral/titanium/blue{
	tag = "icon-whiteredfull";
	icon_state = "whiteredfull";
	dir = 2
	},
/area/template/OriginalClown)
"aw" = (
/obj/structure/cable{
	d1 = 2;
	d2 = 8;
	icon_state = "2-8"
	},
/obj/structure/cable{
	d1 = 2;
	d2 = 4;
	icon_state = "2-4"
	},
/turf/open/floor/mineral/titanium/blue{
	tag = "icon-whitegreenfull";
	icon_state = "whitegreenfull";
	dir = 2
	},
/area/template/OriginalClown)
"ax" = (
/obj/structure/table,
/obj/item/device/flashlight/lamp/bananalamp,
/obj/machinery/light{
	dir = 4;
	icon_state = "tube1"
	},
/obj/item/weapon/bikehorn,
/obj/structure/cable{
	d1 = 1;
	d2 = 8;
	icon_state = "1-8"
	},
/obj/structure/cable{
	d1 = 2;
	d2 = 8;
	icon_state = "2-8"
	},
/turf/open/floor/mineral/titanium/blue{
	tag = "icon-whiteredfull";
	icon_state = "whiteredfull";
	dir = 2
	},
/area/template/OriginalClown)
"ay" = (
/obj/item/chair{
	dir = 8
	},
/obj/structure/cable{
	d1 = 1;
	d2 = 8;
	icon_state = "1-8"
	},
/turf/open/floor/mineral/titanium/blue{
	tag = "icon-whitegreenfull";
	icon_state = "whitegreenfull";
	dir = 2
	},
/area/template/OriginalClown)
"az" = (
/obj/structure/cable{
	d1 = 1;
	d2 = 2;
	icon_state = "1-2"
	},
/turf/open/floor/mineral/titanium/blue{
	tag = "icon-whiteredfull";
	icon_state = "whiteredfull";
	dir = 2
	},
/area/template/OriginalClown)
"aA" = (
/obj/item/chair{
	dir = 4
	},
/obj/structure/cable{
	d1 = 1;
	d2 = 4;
	icon_state = "1-4"
	},
/turf/open/floor/mineral/titanium/blue{
	tag = "icon-whitegreenfull";
	icon_state = "whitegreenfull";
	dir = 2
	},
/area/template/OriginalClown)
"aB" = (
/obj/structure/cable{
	d1 = 1;
	d2 = 2;
	icon_state = "1-2"
	},
/turf/open/floor/mineral/titanium/blue{
	tag = "icon-whitegreenfull";
	icon_state = "whitegreenfull";
	dir = 2
	},
/area/template/OriginalClown)
"aC" = (
/obj/machinery/door/poddoor{
	auto_close = 300;
	id = "cloonshipdoor";
	name = "outer blast door"
	},
/turf/open/space,
/area/template/OriginalClown)
"aD" = (
/obj/structure/cable{
	d1 = 1;
	d2 = 2;
	icon_state = "1-2"
	},
/mob/living/simple_animal/hostile/retaliate/clown,
/turf/open/floor/mineral/titanium/blue{
	tag = "icon-whiteredfull";
	icon_state = "whiteredfull";
	dir = 2
	},
/area/template/OriginalClown)
"aE" = (
/obj/machinery/button/door{
	id = "cloonshipdoor";
	pixel_y = 25
	},
/turf/open/floor/mineral/titanium/blue{
	tag = "icon-whitegreenfull";
	icon_state = "whitegreenfull";
	dir = 2
	},
/area/template/OriginalClown)
"aF" = (
/obj/structure/window/reinforced{
	dir = 1;
	layer = 2.9
	},
/obj/structure/window/reinforced,
/obj/structure/window/reinforced{
	dir = 4
	},
/obj/structure/cable{
	d2 = 8;
	icon_state = "0-8"
	},
/obj/machinery/power/emitter/energycannon{
	active = 0;
	dir = 4;
	locked = 0;
	req_access = "0"
	},
/turf/open/floor/mineral/titanium/blue{
	tag = "icon-whiteredfull";
	icon_state = "whiteredfull";
	dir = 2
	},
/area/template/OriginalClown)
"aG" = (
/obj/structure/table,
/obj/machinery/light{
	icon_state = "tube1";
	dir = 8
	},
/obj/structure/cable{
	d1 = 1;
	d2 = 4;
	icon_state = "1-4"
	},
/obj/structure/cable{
	d1 = 2;
	d2 = 4;
	icon_state = "2-4"
	},
/obj/item/weapon/reagent_containers/food/snacks/store/bread/banana,
/turf/open/floor/mineral/titanium/blue{
	tag = "icon-whiteredfull";
	icon_state = "whiteredfull";
	dir = 2
	},
/area/template/OriginalClown)
"aH" = (
/obj/structure/cable{
	d1 = 4;
	d2 = 8;
	icon_state = "4-8"
	},
/mob/living/simple_animal/hostile/retaliate/clown,
/turf/open/floor/mineral/titanium/blue{
	tag = "icon-whitegreenfull";
	icon_state = "whitegreenfull";
	dir = 2
	},
/area/template/OriginalClown)
"aI" = (
/obj/structure/cable{
	d1 = 4;
	d2 = 8;
	icon_state = "4-8"
	},
/turf/open/floor/mineral/titanium/blue{
	tag = "icon-whiteredfull";
	icon_state = "whiteredfull";
	dir = 2
	},
/area/template/OriginalClown)
"aJ" = (
/obj/machinery/door/airlock/clown,
/obj/structure/cable{
	d1 = 4;
	d2 = 8;
	icon_state = "4-8"
	},
/turf/open/floor/mineral/titanium/blue{
	tag = "icon-whitegreenfull";
	icon_state = "whitegreenfull";
	dir = 2
	},
/area/template/OriginalClown)
"aK" = (
/obj/structure/cable{
	d1 = 1;
	d2 = 2;
	icon_state = "1-2"
	},
/obj/structure/cable{
	d1 = 2;
	d2 = 4;
	icon_state = "2-4"
	},
/obj/structure/cable{
	d1 = 2;
	d2 = 8;
	icon_state = "2-8"
	},
/turf/open/floor/mineral/titanium/blue{
	tag = "icon-whitegreenfull";
	icon_state = "whitegreenfull";
	dir = 2
	},
/area/template/OriginalClown)
"aL" = (
/obj/structure/table,
/obj/item/device/flashlight/lamp/bananalamp,
/obj/machinery/light{
	dir = 4;
	icon_state = "tube1"
	},
/obj/structure/cable{
	d1 = 1;
	d2 = 8;
	icon_state = "1-8"
	},
/obj/structure/cable{
	d1 = 2;
	d2 = 8;
	icon_state = "2-8"
	},
/turf/open/floor/mineral/titanium/blue{
	tag = "icon-whiteredfull";
	icon_state = "whiteredfull";
	dir = 2
	},
/area/template/OriginalClown)
"aM" = (
/obj/structure/window/reinforced{
	dir = 8
	},
/obj/structure/window/reinforced,
/obj/structure/cable{
	icon_state = "0-4";
	d2 = 4
	},
/obj/structure/window/reinforced{
	dir = 1;
	layer = 2.9
	},
/obj/machinery/power/emitter/energycannon{
	active = 0;
	dir = 8;
	icon_state = "emitter";
	in_use = 0;
	locked = 0;
	req_access = "0"
	},
/turf/open/floor/mineral/titanium/blue{
	tag = "icon-whiteredfull";
	icon_state = "whiteredfull";
	dir = 2
	},
/area/template/OriginalClown)
"aN" = (
/obj/structure/statue/bananium/clown,
/turf/open/floor/mineral/titanium/blue{
	tag = "icon-whitegreenfull";
	icon_state = "whitegreenfull";
	dir = 2
	},
/area/template/OriginalClown)
"aO" = (
/obj/structure/chair/comfy/lime{
	dir = 4
	},
/turf/open/floor/mineral/titanium/blue{
	tag = "icon-whitegreenfull";
	icon_state = "whitegreenfull";
	dir = 2
	},
/area/template/OriginalClown)
"aP" = (
/obj/structure/table,
/obj/item/weapon/bikehorn,
/obj/structure/cable{
	d1 = 1;
	d2 = 2;
	icon_state = "1-2"
	},
/obj/item/device/firing_pin/clown,
/turf/open/floor/mineral/titanium/blue{
	tag = "icon-whiteredfull";
	icon_state = "whiteredfull";
	dir = 2
	},
/area/template/OriginalClown)
"aQ" = (
/obj/structure/chair/comfy/lime{
	dir = 8
	},
/turf/open/floor/mineral/titanium/blue{
	tag = "icon-whitegreenfull";
	icon_state = "whitegreenfull";
	dir = 2
	},
/area/template/OriginalClown)
"aR" = (
/obj/structure/chair/comfy/lime{
	dir = 4
	},
/turf/open/floor/mineral/titanium/blue{
	tag = "icon-whiteredfull";
	icon_state = "whiteredfull";
	dir = 2
	},
/area/template/OriginalClown)
"aS" = (
/obj/structure/table,
/obj/item/weapon/reagent_containers/food/snacks/grown/banana{
	potency = 100
	},
/obj/item/weapon/reagent_containers/food/snacks/grown/banana{
	potency = 100
	},
/obj/item/weapon/reagent_containers/food/snacks/grown/banana{
	potency = 100
	},
/obj/item/weapon/reagent_containers/food/snacks/grown/banana{
	potency = 100
	},
/obj/item/weapon/reagent_containers/food/snacks/grown/banana{
	potency = 100
	},
/obj/item/weapon/reagent_containers/food/snacks/grown/banana{
	potency = 100
	},
/obj/structure/cable{
	d1 = 2;
	d2 = 4;
	icon_state = "2-4"
	},
/obj/structure/cable{
	d1 = 1;
	d2 = 2;
	icon_state = "1-2"
	},
/obj/item/weapon/reagent_containers/food/snacks/store/bread/banana,
/turf/open/floor/mineral/titanium/blue{
	tag = "icon-whitegreenfull";
	icon_state = "whitegreenfull";
	dir = 2
	},
/area/template/OriginalClown)
"aT" = (
/obj/machinery/power/apc{
	dir = 4;
	name = "Heavy Honker XI APC";
	pixel_x = 24;
	pixel_y = 0
	},
/obj/structure/chair/comfy/lime{
	dir = 8
	},
/obj/structure/cable{
	d2 = 8;
	icon_state = "0-8"
	},
/turf/open/floor/mineral/titanium/blue{
	tag = "icon-whiteredfull";
	icon_state = "whiteredfull";
	dir = 2
	},
/area/template/OriginalClown)
"aU" = (
/obj/machinery/door/poddoor{
	auto_close = 20;
	id = "cloonmasswest";
	name = "HONK Driver Door"
	},
/turf/open/floor/mineral/titanium/blue{
	tag = "icon-whiteredfull";
	icon_state = "whiteredfull";
	dir = 2
	},
/area/template/OriginalClown)
"aV" = (
/obj/machinery/door/window,
/obj/machinery/mass_driver{
	dir = 8;
	id = "cloonmasswest"
	},
/obj/machinery/portable_atmospherics/canister/toxins,
/turf/open/floor/mineral/titanium/blue{
	tag = "icon-whitegreenfull";
	icon_state = "whitegreenfull";
	dir = 2
	},
/area/template/OriginalClown)
"aW" = (
/obj/structure/window/reinforced,
/obj/machinery/conveyor/auto{
	dir = 8
	},
/obj/machinery/nuclearbomb{
	desc = "State of the art WMD, no weapon of mime destruction has ever been such effective, HONK!";
	name = "thermo honkular device";
	r_code = "HONK"
	},
/turf/open/floor/mineral/titanium/blue{
	tag = "icon-whiteredfull";
	icon_state = "whiteredfull";
	dir = 2
	},
/area/template/OriginalClown)
"aX" = (
/obj/structure/window/reinforced,
/obj/machinery/conveyor/auto{
	dir = 8
	},
/turf/open/floor/mineral/titanium/blue{
	tag = "icon-whitegreenfull";
	icon_state = "whitegreenfull";
	dir = 2
	},
/area/template/OriginalClown)
"aY" = (
/obj/structure/window/reinforced,
/obj/machinery/conveyor/auto{
	dir = 8
	},
/turf/open/floor/mineral/titanium/blue{
	tag = "icon-whiteredfull";
	icon_state = "whiteredfull";
	dir = 2
	},
/area/template/OriginalClown)
"aZ" = (
/obj/machinery/door/window{
	layer = 3.2
	},
/obj/machinery/conveyor/auto{
	dir = 8
	},
/turf/open/floor/mineral/titanium/blue{
	tag = "icon-whitegreenfull";
	icon_state = "whitegreenfull";
	dir = 2
	},
/area/template/OriginalClown)
"ba" = (
/obj/structure/chair/comfy/lime{
	dir = 4
	},
/obj/machinery/light{
	icon_state = "tube1";
	dir = 8
	},
/turf/open/floor/mineral/titanium/blue{
	tag = "icon-whitegreenfull";
	icon_state = "whitegreenfull";
	dir = 2
	},
/area/template/OriginalClown)
"bb" = (
/obj/structure/table,
/obj/item/weapon/reagent_containers/food/snacks/grown/banana{
	potency = 100
	},
/obj/item/weapon/reagent_containers/food/snacks/grown/banana{
	potency = 100
	},
/obj/structure/cable{
	d1 = 1;
	d2 = 2;
	icon_state = "1-2"
	},
/turf/open/floor/mineral/titanium/blue{
	tag = "icon-whiteredfull";
	icon_state = "whiteredfull";
	dir = 2
	},
/area/template/OriginalClown)
"bc" = (
/obj/structure/chair/comfy/lime{
	dir = 8
	},
/obj/machinery/light{
	dir = 4;
	icon_state = "tube1"
	},
/turf/open/floor/mineral/titanium/blue{
	tag = "icon-whitegreenfull";
	icon_state = "whitegreenfull";
	dir = 2
	},
/area/template/OriginalClown)
"bd" = (
/obj/machinery/door/window,
/obj/machinery/conveyor/auto{
	dir = 4
	},
/turf/open/floor/mineral/titanium/blue{
	tag = "icon-whitegreenfull";
	icon_state = "whitegreenfull";
	dir = 2
	},
/area/template/OriginalClown)
"be" = (
/obj/structure/window/reinforced,
/obj/machinery/conveyor/auto{
	dir = 4
	},
/turf/open/floor/mineral/titanium/blue{
	tag = "icon-whiteredfull";
	icon_state = "whiteredfull";
	dir = 2
	},
/area/template/OriginalClown)
"bf" = (
/obj/structure/window/reinforced,
/obj/machinery/conveyor/auto{
	dir = 4
	},
/turf/open/floor/mineral/titanium/blue{
	tag = "icon-whitegreenfull";
	icon_state = "whitegreenfull";
	dir = 2
	},
/area/template/OriginalClown)
"bg" = (
/obj/structure/window/reinforced,
/obj/machinery/conveyor/auto{
	dir = 4
	},
/obj/machinery/portable_atmospherics/canister/toxins,
/turf/open/floor/mineral/titanium/blue{
	tag = "icon-whiteredfull";
	icon_state = "whiteredfull";
	dir = 2
	},
/area/template/OriginalClown)
"bh" = (
/obj/machinery/door/window,
/obj/machinery/mass_driver{
	dir = 4;
	id = "cloonmasseast"
	},
/obj/machinery/portable_atmospherics/canister/toxins,
/turf/open/floor/mineral/titanium/blue{
	tag = "icon-whitegreenfull";
	icon_state = "whitegreenfull";
	dir = 2
	},
/area/template/OriginalClown)
"bi" = (
/obj/machinery/door/poddoor{
	auto_close = 20;
	id = "cloonmasseast";
	name = "HONK Driver Door"
	},
/turf/open/floor/mineral/titanium/blue{
	tag = "icon-whiteredfull";
	icon_state = "whiteredfull";
	dir = 2
	},
/area/template/OriginalClown)
"bj" = (
/obj/item/chair{
	dir = 1
	},
/obj/machinery/button/massdriver{
	id = "cloonmasswest";
	name = "HONK Driver";
	pixel_x = -25;
	pixel_y = 0
	},
/turf/open/floor/mineral/titanium/blue{
	tag = "icon-whiteredfull";
	icon_state = "whiteredfull";
	dir = 2
	},
/area/template/OriginalClown)
"bk" = (
/obj/machinery/door/airlock/clown,
/turf/open/floor/mineral/titanium/blue{
	tag = "icon-whitegreenfull";
	icon_state = "whitegreenfull";
	dir = 2
	},
/area/template/OriginalClown)
"bl" = (
/obj/item/chair{
	dir = 1
	},
/obj/machinery/button/massdriver{
	id = "cloonmasseast";
	name = "HONK Driver";
	pixel_x = 25;
	pixel_y = 0
	},
/turf/open/floor/mineral/titanium/blue{
	tag = "icon-whiteredfull";
	icon_state = "whiteredfull";
	dir = 2
	},
/area/template/OriginalClown)
"bm" = (
/mob/living/simple_animal/hostile/retaliate/clown,
/turf/open/floor/mineral/titanium/blue{
	tag = "icon-whitegreenfull";
	icon_state = "whitegreenfull";
	dir = 2
	},
/area/template/OriginalClown)
"bn" = (
/obj/structure/closet/secure_closet/clown,
/turf/open/floor/mineral/titanium/blue{
	tag = "icon-whitegreenfull";
	icon_state = "whitegreenfull";
	dir = 2
	},
/area/template/OriginalClown)
"bo" = (
/obj/structure/table,
/obj/item/device/flashlight/lamp/bananalamp,
/obj/machinery/light{
	icon_state = "tube1";
	dir = 8
	},
/obj/item/weapon/bikehorn,
/obj/structure/cable{
	d1 = 1;
	d2 = 4;
	icon_state = "1-4"
	},
/obj/structure/cable{
	d1 = 2;
	d2 = 4;
	icon_state = "2-4"
	},
/turf/open/floor/mineral/titanium/blue{
	tag = "icon-whiteredfull";
	icon_state = "whiteredfull";
	dir = 2
	},
/area/template/OriginalClown)
"bp" = (
/obj/structure/cable{
	d1 = 4;
	d2 = 8;
	icon_state = "4-8"
	},
/turf/open/floor/mineral/titanium/blue{
	tag = "icon-whitegreenfull";
	icon_state = "whitegreenfull";
	dir = 2
	},
/area/template/OriginalClown)
"bq" = (
/obj/structure/closet/crate,
/obj/structure/cable{
	d1 = 4;
	d2 = 8;
	icon_state = "4-8"
	},
/obj/item/stack/tile/mineral/bananium{
	amount = 50
	},
/turf/open/floor/mineral/titanium/blue{
	tag = "icon-whiteredfull";
	icon_state = "whiteredfull";
	dir = 2
	},
/area/template/OriginalClown)
"br" = (
/obj/structure/cable{
	d1 = 4;
	d2 = 8;
	icon_state = "4-8"
	},
/turf/closed/wall/mineral/clown,
/area/template/OriginalClown)
"bs" = (
/obj/item/weapon/bedsheet/clown,
/obj/structure/bed,
/obj/structure/cable{
	d1 = 4;
	d2 = 8;
	icon_state = "4-8"
	},
/turf/open/floor/mineral/titanium/blue{
	tag = "icon-whiteredfull";
	icon_state = "whiteredfull";
	dir = 2
	},
/area/template/OriginalClown)
"bt" = (
/obj/item/weapon/bedsheet/clown,
/obj/structure/bed,
/obj/structure/cable{
	d1 = 1;
	d2 = 2;
	icon_state = "1-2"
	},
/obj/structure/cable{
	d1 = 1;
	d2 = 4;
	icon_state = "1-4";
	tag = "90Curve"
	},
/obj/structure/cable{
	d1 = 2;
	d2 = 4;
	icon_state = "2-4"
	},
/obj/structure/cable{
	d1 = 2;
	d2 = 8;
	icon_state = "2-8"
	},
/turf/open/floor/mineral/titanium/blue{
	tag = "icon-whitegreenfull";
	icon_state = "whitegreenfull";
	dir = 2
	},
/area/template/OriginalClown)
"bu" = (
/obj/item/weapon/bedsheet/clown,
/obj/structure/bed,
/obj/structure/cable{
	d1 = 2;
	d2 = 8;
	icon_state = "2-8"
	},
/obj/structure/cable{
	d1 = 4;
	d2 = 8;
	icon_state = "4-8"
	},
/turf/open/floor/mineral/titanium/blue{
	tag = "icon-whiteredfull";
	icon_state = "whiteredfull";
	dir = 2
	},
/area/template/OriginalClown)
"bv" = (
/obj/structure/closet/crate,
/obj/structure/cable{
	d1 = 4;
	d2 = 8;
	icon_state = "4-8"
	},
/obj/item/stack/sheet/mineral/bananium{
	amount = 25
	},
/obj/item/seeds/banana{
	endurance = 1000;
	lifespan = 1000;
	luminosity = 1;
	name = "pack of Genetically HONKineered banana seeds";
	potency = 100;
	yield = 5
	},
/turf/open/floor/mineral/titanium/blue{
	tag = "icon-whiteredfull";
	icon_state = "whiteredfull";
	dir = 2
	},
/area/template/OriginalClown)
"bw" = (
/obj/structure/table,
/obj/machinery/light{
	dir = 4;
	icon_state = "tube1"
	},
/obj/structure/cable{
	d1 = 1;
	d2 = 8;
	icon_state = "1-8"
	},
/obj/structure/cable{
	d1 = 2;
	d2 = 8;
	icon_state = "2-8"
	},
/obj/item/toy/figure/clown,
/turf/open/floor/mineral/titanium/blue{
	tag = "icon-whiteredfull";
	icon_state = "whiteredfull";
	dir = 2
	},
/area/template/OriginalClown)
"bx" = (
/obj/structure/window/reinforced{
	dir = 8
	},
/obj/structure/window/reinforced{
	dir = 1;
	layer = 2.9
	},
/obj/structure/window/reinforced,
/obj/machinery/power/emitter/energycannon{
	active = 0;
	dir = 8;
	icon_state = "emitter";
	in_use = 0;
	locked = 0;
	req_access = "0"
	},
/obj/structure/cable{
	icon_state = "0-4";
	d2 = 4
	},
/turf/open/floor/mineral/titanium/blue{
	tag = "icon-whiteredfull";
	icon_state = "whiteredfull";
	dir = 2
	},
/area/template/OriginalClown)
"by" = (
/obj/structure/tank_dispenser/oxygen,
/turf/open/floor/mineral/titanium/blue{
	tag = "icon-whitegreenfull";
	icon_state = "whitegreenfull";
	dir = 2
	},
/area/template/OriginalClown)
"bz" = (
/obj/machinery/power/terminal{
	dir = 4
	},
/obj/machinery/suit_storage_unit/clown,
/obj/structure/cable,
/turf/open/floor/mineral/titanium/blue{
	tag = "icon-whiteredfull";
	icon_state = "whiteredfull";
	dir = 2
	},
/area/template/OriginalClown)
"bA" = (
/obj/machinery/power/smes{
	charge = 5e+006
	},
/obj/structure/cable{
	icon_state = "0-4";
	d2 = 4
	},
/obj/structure/cable{
	icon_state = "0-2";
	d2 = 2
	},
/obj/structure/cable,
/turf/open/floor/mineral/titanium/blue{
	tag = "icon-whitegreenfull";
	icon_state = "whitegreenfull";
	dir = 2
	},
/area/template/OriginalClown)
"bB" = (
/obj/item/weapon/bikehorn,
/turf/open/floor/mineral/titanium/blue{
	tag = "icon-whiteredfull";
	icon_state = "whiteredfull";
	dir = 2
	},
/area/template/OriginalClown)
"bC" = (
/obj/structure/window/reinforced{
	dir = 1;
	layer = 2.9
	},
/obj/structure/window/reinforced,
/obj/structure/window/reinforced{
	dir = 4
	},
/obj/machinery/power/emitter/energycannon{
	active = 0;
	dir = 4;
	locked = 0;
	req_access = "0"
	},
/obj/structure/cable{
	d2 = 8;
	icon_state = "0-8"
	},
/turf/open/floor/mineral/titanium/blue{
	tag = "icon-whiteredfull";
	icon_state = "whiteredfull";
	dir = 2
	},
/area/template/OriginalClown)
"bD" = (
/obj/item/weapon/bedsheet/clown,
/obj/structure/bed,
/turf/open/floor/mineral/titanium/blue{
	tag = "icon-whiteredfull";
	icon_state = "whiteredfull";
	dir = 2
	},
/area/template/OriginalClown)
"bE" = (
/obj/item/weapon/bedsheet/clown,
/obj/structure/bed,
/turf/open/floor/mineral/titanium/blue{
	tag = "icon-whitegreenfull";
	icon_state = "whitegreenfull";
	dir = 2
	},
/area/template/OriginalClown)
"bF" = (
/obj/machinery/suit_storage_unit/clown,
/turf/open/floor/mineral/titanium/blue{
	tag = "icon-whiteredfull";
	icon_state = "whiteredfull";
	dir = 2
	},
/area/template/OriginalClown)
"bG" = (
/obj/structure/shuttle/engine/heater,
/obj/structure/window/reinforced{
	dir = 1
	},
/turf/open/floor/plating/airless,
/area/template/OriginalClown)
"bH" = (
/obj/structure/shuttle/engine/propulsion{
	icon_state = "propulsion_l"
	},
/turf/open/floor/plating/airless,
/area/template/OriginalClown)
"bI" = (
/obj/structure/shuttle/engine/propulsion,
/turf/open/floor/plating/airless,
/area/template/OriginalClown)
"bJ" = (
/obj/structure/shuttle/engine/propulsion{
	icon_state = "propulsion_r"
	},
/turf/open/floor/plating/airless,
/area/template/OriginalClown)

(1,1,1) = {"
aa
aa
aa
aa
aa
aa
aa
aa
aa
aa
aa
aa
aa
ab
aU
ab
aq
ab
bx
ab
ab
ab
"}
(2,1,1) = {"
aa
aa
aa
aa
aa
aa
aa
aa
aa
aa
aa
aa
aa
ab
aV
bj
ar
bo
ay
bD
bG
bH
"}
(3,1,1) = {"
aa
aa
aa
aa
aa
aa
aa
aa
aa
ab
aq
ab
aM
ab
aW
ai
aj
bp
aj
bE
bG
bI
"}
(4,1,1) = {"
aa
aa
aa
aa
aa
aa
aa
aa
aa
ab
ar
aG
ay
ab
aX
aj
bm
aI
ai
bF
bG
bJ
"}
(5,1,1) = {"
ab
ac
ac
ab
ab
aa
aa
aa
aa
ab
aj
aH
aj
ab
aY
ai
aj
bp
ab
ab
ab
ab
"}
(6,1,1) = {"
ac
ad
ai
al
ab
aa
aa
aa
aa
ab
ai
aI
aN
ab
aZ
aj
bn
bq
ab
aa
aa
aa
"}
(7,1,1) = {"
ac
ae
aj
am
ab
ab
aq
ab
aq
ab
ab
aJ
ab
ab
ab
bk
ab
br
ab
ab
ab
aa
"}
(8,1,1) = {"
ac
af
ak
aj
ab
ap
ar
av
ay
aj
ai
aI
aO
aR
ba
aj
ai
bs
by
bG
bH
aa
"}
(9,1,1) = {"
ac
ag
aj
ai
ao
ai
as
aw
az
aB
aD
aK
aP
aS
bb
aB
az
bt
bz
bG
bI
aa
"}
(10,1,1) = {"
ac
af
ak
aj
ab
aj
at
ax
aA
aj
ai
aI
aQ
aT
bc
aj
ai
bu
bA
bG
bJ
aa
"}
(11,1,1) = {"
ac
ah
aj
am
ab
ab
au
ab
au
ab
ab
aJ
ab
ab
ab
bk
ab
br
ab
ab
ab
aa
"}
(12,1,1) = {"
ac
ad
ai
an
ab
aa
aa
aa
aa
ab
aE
aI
aN
ab
bd
aj
bn
bv
ab
aa
aa
aa
"}
(13,1,1) = {"
ab
ac
ac
ab
ab
aa
aa
aa
aa
aC
aj
aH
aj
ab
be
ai
aj
bp
ab
ab
ab
ab
"}
(14,1,1) = {"
aa
aa
aa
aa
aa
aa
aa
aa
aa
ab
at
aL
aA
ab
bf
aj
bm
aI
ai
bF
bG
bH
"}
(15,1,1) = {"
aa
aa
aa
aa
aa
aa
aa
aa
aa
ab
aF
ab
aF
ab
bg
ai
aj
bp
bB
bE
bG
bI
"}
(16,1,1) = {"
aa
aa
aa
aa
aa
aa
aa
aa
aa
aa
aa
aa
aa
ab
bh
bl
at
bw
aA
bD
bG
bJ
"}
(17,1,1) = {"
aa
aa
aa
aa
aa
aa
aa
aa
aa
aa
aa
aa
aa
ab
bi
ab
aF
ab
bC
ab
ab
ab
"}
