//MAP CONVERTED BY dmm2tgm.py THIS HEADER COMMENT PREVENTS RECONVERSION, DO NOT REMOVE 
"a" = (
/turf/open/space,
/area/space)
"b" = (
/turf/closed/mineral/random,
/area/space)
"c" = (
/turf/open/floor/plating/asteroid/airless,
/area/space)
"d" = (
/turf/closed/mineral/random/high_chance,
/area/space)
"e" = (
/obj/structure/shuttle/engine/propulsion/burst{
	dir = 4
	},
/turf/open/floor/plating/airless,
/area/space)
"f" = (
/obj/structure/girder,
/turf/open/floor/plating/airless,
/area/space)
"g" = (
/turf/closed/wall/mineral/titanium,
/area/space)
"h" = (
/turf/closed/mineral/random,
/turf/closed/wall/mineral/titanium{
	dir = 2;
	icon_state = "swall_f10";
	layer = 2
	},
/area/space)
"i" = (
/obj/machinery/door/airlock/shuttle{
	name = "Escape Pod Airlock"
	},
/turf/open/floor/mineral/titanium/blue,
/area/space)
"j" = (
/obj/structure/chair{
	dir = 4
	},
/obj/item/device/radio/intercom{
	pixel_y = 25
	},
/obj/item/weapon/storage/pod{
	pixel_y = -30
	},
/obj/effect/mob_spawn/human/engineer/rig{
	brute_damage = 200
	},
/obj/effect/decal/cleanable/blood,
/turf/open/floor/mineral/titanium/blue,
/area/space)
"k" = (
/obj/structure/chair{
	dir = 4
	},
/obj/machinery/status_display{
	density = 0;
	layer = 3;
	pixel_x = 0;
	pixel_y = 32
	},
/obj/machinery/computer/shuttle/pod{
	pixel_y = -30;
	possible_destinations = "asteroid_pod4";
	shuttleId = "pod4"
	},
/turf/open/floor/mineral/titanium/blue,
/area/space)
"l" = (
/obj/structure/grille{
	density = 0;
	icon_state = "brokengrille"
	},
/obj/effect/gibspawner/human,
/obj/item/clothing/under/rank/engineer,
/obj/item/clothing/shoes/workboots,
/obj/item/clothing/head/hardhat/orange,
/obj/item/clothing/gloves/color/yellow,
/obj/item/weapon/storage/belt/utility/full,
/obj/item/stack/rods,
/obj/effect/decal/cleanable/blood/old,
/turf/open/floor/plating/airless,
/area/space)
"m" = (
/obj/effect/decal/cleanable/blood/old,
/turf/closed/mineral/random,
/area/space)
"n" = (
/turf/closed/mineral/random,
/turf/closed/wall/mineral/titanium{
	icon_state = "swall_f9";
	dir = 2
	},
/area/space)

(1,1,1) = {"
a
a
a
a
e
i
e
a
a
"}
(2,1,1) = {"
a
a
c
c
f
j
g
c
a
"}
(3,1,1) = {"
a
c
c
b
g
k
f
c
c
"}
(4,1,1) = {"
a
c
b
b
h
l
n
b
b
"}
(5,1,1) = {"
a
b
b
b
d
m
b
b
b
"}
(6,1,1) = {"
b
b
d
d
d
d
b
b
b
"}
(7,1,1) = {"
b
b
b
d
d
b
b
b
a
"}
(8,1,1) = {"
a
b
b
b
b
b
b
a
a
"}
(9,1,1) = {"
a
a
b
b
b
a
a
a
a
"}
